10 10
1 1
1 1 1 1 1 1 1 1 1 1
1 5 0 1 0 0 1 0 0 1
1 4 4 0 1 0 0 0 0 1
1 0 0 1 0 4 0 1 1 1
1 1 0 1 0 1 1 0 0 2
1 0 0 1 0 0 1 4 0 1
1 0 4 0 0 0 0 4 0 1
1 1 0 1 0 1 0 1 1 1
1 0 0 0 0 1 0 0 0 1
1 1 1 1 1 1 1 1 1 1